[["w","w","w","w","w","w","w"],
 ["w","w","f","f","f","w","w"],
 ["w","f","f","w","f","f","w"],
 ["w","f","f","g","f","f","w"],
 ["w","f","f","g","f","f","w"],
 ["w","w","f","g","f","w","w"],
 ["w","w","w","w","w","w","w"]];
 [[2,3],[3,3],[4,3]];
 [[80,120],[120,120],[160,120]];
 [2,1];
 [80,40]