[["w","w","w","w","w","w","w"],
 ["w","w","w","f","f","w","w"],
 ["w","f","f","g","f","w","w"],
 ["w","f","f","f","f","f","w"],
 ["w","f","w","g","f","f","w"],
 ["w","f","f","f","f","f","w"],
 ["w","w","w","w","w","w","w"]];
 [[4,2],[4,3]];
 [[160,80],[160,120]];
 [1,2];
 [40,80]