[["w","w","w","w","w","w","w","w"],
 ["w","w","f","f","f","f","w","w"],
 ["w","f","g","g","f","f","f","w"],
 ["w","f","w","f","f","f","f","w"],
 ["w","f","f","f","w","f","g","w"],
 ["w","w","w","w","w","w","w","w"]];
[[4,3],[5,3],[6,3]];
[[160,120],[200,120],[240,120]];
[5,4];
[200,160]