[["w", "w", "w", "w", "w"],
 ["w", "w", "f", "w", "w"],
 ["w", "f", "f", "w", "w"],
 ["w", "w", "f", "f", "w"],
 ["w", "f", "f", "w", "w"],
 ["w", "w", "f", "f", "w"],
 ["w", "f", "f", "w", "w"],
 ["w", "w", "f", "f", "w"],
 ["w", "w", "g", "w", "w"],
 ["w", "w", "w", "w", "w"]];
[[2,2]];
[[80,80]];
[2,1];
[80,40]
