[["w", "w", "w", "w", "w", "w", "w"],
 ["w", "f", "f", "f", "f", "f", "w"],
 ["w", "f", "g", "f", "g", "f", "w"],
 ["w", "f", "f", "f", "f", "f", "w"],
 ["w", "f", "f", "f", "f", "f", "w"],
 ["w", "f", "f", "f", "f", "f", "w"],
 ["w", "f", "f", "f", "f", "f", "w"],
 ["w", "w", "w", "w", "w", "w", "w"]];
[[3, 2], [3, 4]];
[[120,80],[120,160]];
[3, 3];
[120, 120]
