[["w","w","w","w","w","w"],
 ["w","f","f","f","f","w"],
 ["w","f","w","w","w","w"],
 ["w","f","w","w","w","w"],
 ["w","g","w","w","w","w"],
 ["w","w","w","w","w","w"]];
 [[1, 2]];
 [[40, 80]];
 [3,1];
 [120,40]