[["w","w","w","w","w","w","w"],
 ["w","f","f","f","f","w","w"],
 ["w","f","f","f","f","f","w"],
 ["w","f","w","g","f","g","w"],
 ["w","f","f","f","f","f","w"],
 ["w","w","w","w","w","w","w"]];
 [[2,2],[3,2]];
 [[80,80],[120,80]];
 [1,1];
 [40,40]