[["w","w","w","w","w","w","w","w"],
 ["w","f","f","f","f","w","w","w"],
 ["w","f","f","f","g","g","f","w"],
 ["w","f","f","f","f","f","f","w"],
 ["w","f","f","w","f","g","f","w"],
 ["w","w","w","w","w","w","w","w"]];
[[2,3],[3,3],[4,3]];
[[80,120],[120,120],[160,120]];
[5,3];
[200,120]