[["w","w","w","w","w","w","w","w"],
 ["w","w","g","f","f","w","w","w"],
 ["w","f","f","w","f","f","f","w"],
 ["w","f","f","w","f","w","f","w"],
 ["w","f","g","f","f","f","g","w"],
 ["w","f","f","f","f","w","w","w"],
 ["w","w","w","w","w","w","w","w"]];
[[5,2],[2,4],[5,4]];
[[200,80],[80,160],[200,160]];
[6,2];
[240,80]